HHHHHHHHHHHHH
H  B B BD DDH
H B B B  DDDH
H  B B BD DDH
H B B B  DDDH
H  B B BD DDH
H B B B  DDDH
H  B B BD DDH
H B B B  DDDH
H  B B BD DDH
HWB B B  DDDH
HHHHHHHHHHHHH