HHHHHHHH
H  H   H
H BDDB H
HWBDC HH
H BDDB H
H  H   H
HHHHHHHH