   HHHHHHH
  HH  H WH
  H   H  H
  HB B B H
  H BHH  H
HHH B H HH
HDDDDD  H
HHHHHHHHH
