              HHHHHHHH
              H  DDDDH
   HHHHHHHHHHHH  DDDDH
   H    H  B B   DDDDH
   H BBBHB  B H  DDDDH
   H  B     B H  DDDDH
   H BB HB B BHHHHHHHH
HHHH  B H     H
H   H HHHHHHHHH
H    B  HH
H BBHBB WH
H   H   HH
HHHHHHHHH