HHHHHHHHHHHH
HDD  H     HHH
HDD  H B  B  H
HDD  HBHHHH  H
HDD    W HH  H
HDD  H H  B HH
HHHHHH HHB B H
  H B  B B B H
  H    H     H
  HHHHHHHHHHHH