
        HHHHHHHHH
      HHH   H   H
      HWB  B BB H
HHHHHHHHHH      H
HDHHH   HH  HHB H 
HDDDDDBD  HH B  H
H BHH  HB H  B  H
H   H  B  DDDDDDH
HH BHH  HHHHHHHHH
 H B HHHH
 H B B H
 H     H
 HHHHHHH