 HHHH
 HW HHH
 H B  H
HHH H HH
HDH H  H
HDB  H H
HD   B H
HHHHHHHH