HHHHHH  HHH 
HDD  H HHWHH
HDD  HHH   H
HDD     BB H
HDD  H H B H
HDDHHH H B H
HHHH B HB  H
   H  BH B H
   H B  B  H
   H  HH   H
   HHHHHHHHH  