   HHHH               
   H  HHHHHH          
  HH    H  HHHHHHHHHH 
  H   H  B H  H     H 
HHH H HHH  H B  B H H 
H   HB  HH H  HH HH HH
H HHHWH  H HHDDDBB B H
H  DBDBDB    DDD  H  H
HHH HBHH HBHHDDH  H HH
  H  DH    HHHDHH H H 
  HHHBH HHHH HD  B  H 
    H   H    HHH   HH 
    HHHHH      HHHHH  