       HHHH
HHHHHHHH  HHHH
H   HHDDDDD  H
H  B  HHDDDH H
HH  B  HHH H H
 H H B  H    H
 H  H B  H   H
 H   H B  H  H
 H    H B H HH
 HHHH  H B  H
    HH  H B H
     HHWH   H
      HHHHHHH