    HHHHH
    H   H
    HB  H
  HHH  BHHH
  H  B  B H
HHH H HHH H     HHHHHH
H   H HHH HHHHHHH  DDH
H B  B             DDH
HHHHH HHHH HWHHHH  DDH
    H      HHH  HHHHHH
    HHHHHHHH
