   HHHH
  HH  HHH
HHH     H
H B  B  H  HHHH
HW H HHHHHHH  HH
H B   H B      H
HH  BHH BBH  H H
 HH   B    H   H  HHHH
  H  HHHB B B BH HH  HH
  HHHH H   H B H H DDDH
       H  B B  H H DDDH
       HHHB BB HHHHDDDH
         H  H   BDDDDDH
         HH    B CH DDH
          HHHHH  DDDDHH
              HHHHHHHH 
