 HHHHHHHH 
 HDDDDDDH 
 HDDHHDDH
 HDDDDDDH
 HDDCCDDH
 HHHDDHHH
 H  BB  H
 H      H
 H BBBB H
HHH    HHH
H  BBBB  H
H        H
H BBBBBB H
HH      HH
H BBBBBB H
H   W    H
H  HHHH  H
HHHH  HHHH
