HHHHHHHHHHHH  HHHHHH
H   H    HWHHHHDDDDH
H   BBH       DDDDDH
H   H HHH   HH DDDDH
HH HH HHH  H   DDDDH
 H B B     H HH HHHH
 H  B BHH  H       H
HHHH H  HHHH HH HH H
H  H HB   HH HH    H
H B  B  H HH HHHHHHH
H H B B    H H
H  B HH HH H H
H BB     BB  H
HH HH HHH B  H
 H    H H    H
 HHHHHH HHHHHH
