     HHHH
   HHH  HH
HHHH  B  H
H   B B  HHHH
H B   H B   H HHHH
H  H  H   B H HDDH
HHBHB HHHHBHHHHDDH
 H   HHHHH HH DDDH
 HBH HHWHH HH  DDH
 H H    B     DDDH
 H   HHHH HHH  DDH
 HHH HH H  HH DDDH
  HHB HHHHB HHHDDH
  H   HH    H HDDH
 HH BBHH  B H HHHH
 H     BBBB H
 H B HHH    H
 H   H HHHHHH
 HHHHH